Angela Giovanna Espinosa Restrepo's profile photo	Angela Giovanna Espinosa Restrepo	agespinosar@unal.edu.co
Brayan Stiwar Muñoz Chamorro's profile photo	Brayan Stiwar Muñoz Chamorro	bsmunozc@unal.edu.co
Carlos Manuel Montoya's profile photo	Carlos Manuel Montoya	cmmontoyag@unal.edu.co
Daniel Celin Rua's profile photo	Daniel Celin Rua	decelinr@unal.edu.co
Daniel Diaz Llanos's profile photo	Daniel Diaz Llanos	ddiazl@unal.edu.co
Daniela Mendieta Osorio's profile photo	Daniela Mendieta Osorio	dmendietao@unal.edu.co
Estafia Imbachi Escobar's profile photo	Estafia Imbachi Escobar	eimbachie@unal.edu.co
Esteban Noreña Arroyave's profile photo	Esteban Noreña Arroyave	enorenaa@unal.edu.co
Harold Esteban Bolaños Serna's profile photo	Harold Esteban Bolaños Serna	hebolanoss@unal.edu.co
Harry Garcia Martin's profile photo	Harry Garcia Martin	hadgarciama@unal.edu.co
Jacobo Posada Hoyos's profile photo	Jacobo Posada Hoyos	jposadah@unal.edu.co
Jhon Edwin Grajales Cardona's profile photo	Jhon Edwin Grajales Cardona	jegrajalesc@unal.edu.co
Joan Sebastian Jimenez's profile photo	Joan Sebastian Jimenez	josjimenezja@unal.edu.co
Juan Camilo López Yusty's profile photo	Juan Camilo López Yusty	jclopezy@unal.edu.co
Juan David Zuluaga Cardona's profile photo	Juan David Zuluaga Cardona	jdzuluagac@unal.edu.co
Juan José Jaramillo Granada's profile photo	Juan José Jaramillo Granada	jjjaramillogranada97@gmail.com
Julian Andrés Duarde Castañeda's profile photo	Julian Andrés Duarde Castañeda	juaduardeca@unal.edu.co
Kevin Leonardo Cerpa Campanella's profile photo	Kevin Leonardo Cerpa Campanella	klcerpac@unal.edu.co
Melqui Camacho Espitia's profile photo	Melqui Camacho Espitia	mcamachoe@unal.edu.co
Nicolas Silva Palacios's profile photo	Nicolas Silva Palacios	nsilvap@unal.edu.co
Santiago Meza Machado's profile photo	Santiago Meza Machado	smezam@unal.edu.co
Sebastián Ramírez González	seramirezgo@unal.edu.co